#####################
#****...........****#
#****.....$.....****#
#****.....$.....****#
#****$....$....$****#
#...$$.........$$...#
#...................#
#.........$.........#
#.........$.........#
#..$$$....$....$$$..#
#...................#
#...................#
#.........$.........#
#.........$.........#
#...$$....$....$$...#
#****$.........$****#
#****...........****#
#****...........****#
#****.....$.....****#
#####################