{
    "name": "next",
    "map_width": 35,
    "map_height": 19,
    "tilemap": [
		[1, 1, 1, 1, 1, 1, 1, 1, 1, 1, 1, 1, 1, 1, 1, 1, 1, 1, 1, 1, 1, 1, 1, 1, 1, 1, 1, 1, 1, 1, 1, 1, 1, 1, 1],
		[1, 4, 0, 0, 0, 0, 0, 0, 0, 0, 0, 0, 0, 0, 0, 0, 0, 0, 0, 0, 0, 0, 0, 0, 0, 0, 0, 0, 0, 0, 0, 0, 0, 4, 1],
		[1, 0, 0, 0, 0, 0, 0, 0, 0, 0, 0, 0, 3, 0, 0, 0, 0, 0, 0, 0, 0, 0, 0, 0, 0, 0, 0, 0, 0, 0, 0,23, 0, 0, 1],
		[1, 0,36, 0, 0,21, 0, 0, 0,31, 0, 0, 0,12, 0,22, 0, 0, 0,38, 0,12, 0, 0, 0,32, 0, 0, 0,22, 0, 0, 0, 0, 1],
		[1, 0, 0, 0, 0, 0, 0, 0, 0, 0, 0, 0, 0, 0, 0, 0, 0, 0, 0, 0, 0, 0, 0, 0, 0, 0, 0, 0, 0, 0, 0, 0, 0, 0, 1],
		[1, 0, 0, 0, 0, 0, 0,25, 0, 0, 0, 0, 0, 0, 0, 0, 0, 0, 0, 0, 0, 0, 0, 0, 0, 0, 0, 0, 0, 0, 0, 0, 0, 0, 1],
		[1,27, 0,12, 0, 0, 0, 0, 0, 0, 0, 0, 0, 0, 0, 0, 0,35, 0, 0, 0, 0, 0, 0, 0, 0, 0, 0, 0, 0, 0,12, 0,38, 1],
		[1, 0, 0, 0, 0, 0, 0, 0, 0, 0, 0,34, 0,21, 0, 0, 0, 0, 0, 0, 0,31, 3, 0, 0, 0, 0,23, 0, 0, 0, 0, 0, 0, 1],
		[1, 0, 0, 0, 0, 3, 0, 0, 0, 0, 0, 0, 0, 0, 0, 0, 0, 0, 0, 0, 0, 0, 0, 0, 0, 0, 0, 0, 0, 0, 0, 0, 0, 0, 1],
		[1,39, 0,36, 0, 0, 0, 0, 0,13, 0, 0, 0, 0, 0, 0, 0,13, 0, 0, 0, 0, 0, 0, 0,13, 0, 0,28, 0, 0,33, 0,29, 1],
		[1, 0, 0, 0, 0, 0, 0, 0, 0, 0, 0, 0, 0, 0, 0, 0, 0, 0, 0, 0, 0, 0, 0, 0, 0, 0, 0, 0, 0, 0, 0, 0, 0, 0, 1],
		[1, 0, 0, 0, 0, 0, 0,24, 0, 0, 0, 0, 0,29, 0, 0, 0, 0, 0,32, 0,39, 0,33, 0, 0, 0, 0, 0, 0, 0, 0, 0, 0, 1],
		[1,37, 0,12, 0, 0, 0, 0, 0, 0, 0, 0, 0, 0, 0, 0, 0, 0, 0, 0, 0, 0, 0, 0, 0, 0, 0,26, 0, 0, 0,12, 0,28, 1],
		[1, 0, 0, 0, 0, 0, 0, 0, 0, 0, 0, 0, 0, 0, 0, 0, 0, 0, 0, 0, 0, 0, 0, 0, 0, 0, 0, 0, 0, 0, 0, 0, 0, 0, 1],
		[1, 0, 0, 0, 0,26, 0, 0, 0, 0,35, 0, 0, 0, 0, 0, 0, 0, 0, 0, 0, 0, 0, 0, 0,34, 0, 0, 0,24, 0, 0, 0, 0, 1],
		[1, 0, 0, 0, 0, 0, 0, 0, 0, 0, 0, 0, 0,12, 0,25, 0, 0, 0,37, 0,12, 0, 0, 0, 0, 0, 0, 0, 0, 0, 0, 0, 0, 1],
		[1, 0, 5, 0, 0, 0, 0,27, 0, 0, 0, 0, 0, 0, 2, 0, 0, 0, 0, 0, 0, 0, 0, 0, 0, 0, 0, 0, 0, 0, 0, 0, 5, 0, 1],
		[1, 0, 0, 0, 0, 0, 0, 0, 0, 0, 0, 0, 0, 0, 0, 0, 0, 0, 0, 0, 0, 0, 0, 0, 0, 0, 0, 0, 0, 0, 0, 0, 0, 0, 1],
		[1, 1, 1, 1, 1, 1, 1, 1, 1, 1, 1, 1, 1, 1, 1, 1, 1, 1, 1, 1, 1, 1, 1, 1, 1, 1, 1, 1, 1, 1, 1, 1, 1, 1, 1]
    ]
}
 
